지역,누적확진자수,신규확진자수,해외유입,지역발생,격리중,격리해제,누적 사망
2020년4월8일,10384,53,24,29,3408,6776,200
서울,578,11,6,5,407,169,2
부산,125,2,2,0,28,94,3
대구,6803,9,0,9,1705,4961,137
인천,84,4,0,4,57,27,0
광주,27,0,0,0,12,15,0
대전,39,0,0,0,19,20,0
울산,40,0,0,0,11,28,1
세종,46,0,0,0,32,14,0
경기,596,6,1,5,349,237,10
강원,49,2,0,2,24,24,1
충북,45,0,0,0,16,29,0
충남,137,0,0,0,31,106,0
전북,17,1,1,0,10,7,0
전남,15,0,0,0,11,4,0
경북,1320,3,0,3,320,954,46
경남,113,1,0,1,33,80,0
제주,12,0,0,0,8,4,0
검역,338,14,14,0,335,3,0
