2020년 4월 7,누적확진자수,신규확진자수,해외유입,지역발생,격리중,격리해제,누적 사망
전체,10284,47,16,31,3500,6598,186
서울,563,11,5,6,412,151,0
부산,122,0,0,0,28,91,3
대구,6781,13,1,12,1787,4865,129
인천,80,1,0,1,53,27,0
광주,27,0,0,0,12,15,0
대전,39,2,1,1,20,19,0
울산,40,0,0,0,12,27,1
세종,46,0,0,0,29,17,0
경기,580,8,2,6,360,213,7
강원,45,0,0,0,21,23,1
충북,45,0,0,0,16,29,0
충남,136,1,0,1,34,102,0
전북,16,0,0,0,9,7,0
전남,15,0,0,0,11,4,0
경북,1316,2,0,2,349,922,45
경남,111,2,0,2,31,80,0
제주,12,0,0,0,8,4,0
검역,310,7,7,0,308,2,0
